...................................................................................
....cc......c......cc......c........cc...........cc......c.c.....c...........ccc...
...................................................................................
...P........................p....rr.....s..p.s..g..................................
...ss...................s...ssssssss.....s....s....................................
......................s............................................................
......aa.rgp.p......p..s...........................ggp........rr............rg.....h
ssssssssssssssssssssssssssssss.........sssssss.ssssssssssssssssssssssssssssssssssss

