.ff...tt..
.f......S.
........b.
....P...b.
...ss.....
..B.......
.......pfp
ssssssssss