.ff...tt........................................................................
.f......S.............p.........................................................
........b.............s.w......................s................................
...P....b............s..w.s..p.........s..p.s..p................................
...ss...............s...w....ssssssss.....s....s................................
...................s....w.......................................................
.......pfp........s.....w.......................................................
sssssssssssssssssssssssss.............sssssss.ssssssssssssssssssssssssssssssssss
