wwwwwwhwwws
.s.f......s
psb..b.p..s
.s..fBBf..t
.....tt...s
......t...t
......bf..t
.ff...tt..t
.f......S.t
........b.t
....P...b.t
...ss.....t
..B.......t
.......pfpt
sssssssssst