.ff...tt..........................................
.f......S.........................................
........b.............s.s.........................
...P....b............s..s.........................
...ss...............s...s.........................
...................s....s.........................
.......pfp........s.....s.........................
ssssssssssssssssssssssssssssssssssssssssssssssssss