...................................................................................
....cc......c......cc......c........cc...........cc......c.c.....c...........ccc...
...................................................................................
...P........................p....pp.....s..p.s..p..................................
...ss...................s...ssssssss.....s....s....................................
......................s............................................................
......aa...p.p......p..s..........................................................h
ssssssssssssssssssssssssssssss.........sssssss.ssssssssssssssssssssssssssssssssssss
