.ff...tt............
.f......S...........
........b...........
...P....b...........
...ss...............
....................
.......pfp..........
ssssssssssssssssssss